43
9
0 0 0 0 0 0 0 0 0 0 0 0 0 0 0 22 22 22 22 22 22 22 22 22 22 22 22 22 22 22 22 22 22 22 22 22 22 22 22 22 22 22 22 
0 0 0 0 0 0 0 0 0 0 0 0 0 0 0 22 0 0 0 0 0 0 0 0 0 0 0 0 0 0 0 0 0 0 0 0 0 0 0 0 0 0 22
21 2 0 0 0 0 0 0 0 0 0 0 0 0 0 22 0 0 10 0 0 0 0 0 0 0 0 0 0 0 0 0 0 0 0 0 0 0 0 0 0 0 22
22 4 0 0 0 0 0 0 10 0 0 0 0 0 23 13 25 0 23 25 0 0 0 0 9 0 0 0 0 1 21 2 0 0 0 0 0 0 0 0 10 0 22 
22 4 0 0 0 23 24 24 24 25 0 0 0 0 0 11 0 0 0 1 21 21 21 21 21 21 21 21 21 21 6 4 0 0 9 0 0 23 24 24 24 24 22 
22 4 0 0 0 0 0 0 0 0 0 0 11 1 21 21 2 0 0 0 0 0 0 0 0 0 0 0 0 0 0 0 0 23 25 0 0 0 0 0 0 0 22 
22 4 0 23 24 25 0 0 0 0 1 21 21 21 6 22 4 0 0 0 0 0 10 9 0 0 0 0 0 0 0 0 0 0 0 0 0 11 0 0 0 0 22  
22 4 9 0 10 0 0 0 0 9 3 22 22 22 22 22 4 0 0 1 21 21 21 21 21 2 0 0 0 0 0 0 0 0 9 1 21 21 2 0 16 0 22 
5 21 21 21 21 21 21 21 21 21 21 6 22 22 22 5 21 21 21 21 6 22 22 22 5 21 21 21 21 21 21 21 21 21 21 21 6 22 22 22 22 22 22 
